NO ./textures/1.xpm
SO ./textures/2.xpm
EA ./textures/4.xpm
WE ./textures/5.xpm
F 36,38,51
C 1,5,28

-1111111111111111
-1000000000000001
-1000000000000001
-1000000N00000001
-1000000000000001
-1111111111111111

11111111
10100001
10100001
10100001
10000001
10N00101
10000001
11111111
