NO ./textures/42_cat.xpm
SO ./textures/astro_cat.xpm
EA ./textures/space_cats.xpm
WE ./textures/devs.xpm
F 36,38,51
C 1,5,28

11111111
10100001
10100001
10100001
10000001
1N000101
10000001
11N11011
