SO ./textures/space_cats.xpm
NO ./textures/astro_cat.xpm
EA ./textures/devs.xpm
WE ./textures/42_cat.xpm
F 36,38,51
C 1,5,28

111111111111111111111
100010000000100000001
10001X0X1000100010001
11P110001000100010001
10001X0X1000100010001
100010001000100010001
11O11X0X1000100010001
100010001000100010001
10001X0X1000100010001
100010001000100010001
11P11X0X1000100010001
10001X0X1000100010001
100010001000100010001
1000N0001000000010001
111111111111111111111


