NO ./textures/thabeck-.xpm
SO ./textures/matcardo.xpm
EA ./textures/42_cat.xpm
WE ./textures/42_cat.xpm
F 36,38,51
C 1,5,28

1111111111111111111111111111111111111111111111111
1000000001000000000100000000010000000001000000001
1000100001000010000100001000010000100001000010001
1000100001000010000100001000010000100001000010001
1000100001000010000100001000010000100001000010001
1000100001000010000100001000010000100001000010001
1000100001000010000100001000010000100001000010001
1000100001000010000100001000010000100001000011011
1000100001000010000100001000010000100001000010001
1000100001000010000100001000010000100001000010001
1000100001000010000100001000010000100001000010001
1000100001000010000100001000010000100001000011011
1000100001000010000100001000010000100001000010001
1000100001000010000100001000010000100001000010001
1000100001000010000100001000010000100001000010001
1000100001000010000100001000010000100001000010001
1000100001000010000100001000010000100001000011011
1000100001000010000100001000010000100001000010001
1000100001000010000100001000010000100001000010001
1000100001000010000100001000010000100001000010001
1000100001000010000100001000010000100001000010001
1000O00001000010000100001000010000100001000010001
10N0P00001000010000100001000010000100001000011011
1000100000000010000000001000000000100000000010001
1111111111111111111111111111111111111111111111111
