SO ./textures/space_cats.xpm
NO ./textures/astro_cat.xpm
EA ./textures/devs.xpm
WE ./textures/42_cat.xpm
F 36,38,51
C 1,5,28

111111111111111111111
10S010000000100000001
100010001000100010001
11P110001000100010001
100010001000100010001
100010001000100010001
11O110001000100010001
100010001000100010001
100010001000100010001
100010001000100010001
11P111O11000100010001
100010001000100010001
100010001000100010001
100000001000000010001
111111111111111111111


